>>>>>>>>>>>>>>>s>>>>>>>>vv
>>>>>>>>>>>>>>>s>>>>>>>>vv
^^D#D###vv###D##SS#####Dvv
^^######vv######^^######vv
^^D#####vvD#####^^#####Dvv
^^######vv######^^######vv
^^######vv######^^######vv
^^#D#D##SS######^^####D#vv
^^s<<<<<<<s<<<<<<<s<<<<<vv
^^s<<<<<<<s<<<<<<<s<<<<<vv
SS######vv#D####SS#D####vv
^^######vv######^^#####Dvv
^^######vv######^^#####Dvv
^^D#####vv#####D^^######vv
^^######vv######^^######vv
^^###D##SS####D#^^##D###SS
^^>>>>>s>>>>>>>>>>>>>>>svv
^^>>>>>s>>>>>>>>>>>>>>>svv
^^###D##vv####D####D####vv
^^######vv##############vv
^^D####Dvv#############Dvv
^^######vv##############vv
^^######vv##############vv
^^##D###SS#########D####vv
^^<<<<<<<<s<<<<<<<<<<<<<<<
^^<<<<<<<<s<<<<<<<<<<<<<<<