>>>>>>>>>>>>>>>s>>>>>>>>vv
>>>>>>>>>>>>>>>s>>>>>>>>vv
^^##D###vv######SS#####Dvv
^^######vv######^^######vv
^^######vvD#####^^######vv
^^######vv######^^######vv
^^######vv######^^######vv
^^###D##SS######^^####D#vv
^^s<<<<<<<s<<<<<<<s<<<<<vv
^^s<<<<<<<s<<<<<<<s<<<<<vv
SS######vv######SS######vv
^^######vv######^^######vv
^^######vv######^^######vv
^^D#####vv#####D^^######vv
^^######vv######^^######vv
^^######SS######^^######SS
^^>>>>>s>>>>>>>>>>>>>>>svv
^^>>>>>s>>>>>>>>>>>>>>>svv
^^######vv####D#########vv
^^######vv##############vv
^^#####Dvv#############Dvv
^^######vv##############vv
^^######vv##############vv
^^######SS#########D####vv
^^<<<<<<<<s<<<<<<<<<<<<<<<
^^<<<<<<<<s<<<<<<<<<<<<<<<
